8 6 6 6 6 6 6 6 6 6 7
1 9 10 9 10 9 10 9 10 9 2
1 0 0 0 0 0 0 0 0 0 2
1 0 0 0 0 0 0 0 0 0 2
1 0 0 0 0 0 0 0 0 0 2
1 0 0 0 0 0 0 0 0 0 2
1 0 0 0 0 0 0 0 0 0 2
1 0 0 0 0 0 0 0 0 0 2
1 0 0 0 0 0 0 0 0 0 2
1 0 0 0 0 0 0 0 0 0 2
1 0 0 0 0 0 0 0 0 0 2
1 0 0 0 0 0 0 0 0 0 2
1 0 0 0 0 0 0 0 0 0 2
1 0 0 0 0 0 0 0 0 0 2
1 0 0 0 0 0 0 0 0 0 2
1 0 0 0 0 0 0 0 0 0 2
1 0 0 0 0 0 0 0 0 0 2
1 0 0 0 0 0 0 0 0 0 2
1 0 0 0 0 0 0 0 0 0 2
1 0 0 0 0 0 0 0 0 0 2
1 0 0 0 0 0 0 0 0 0 2
1 0 0 0 0 0 0 0 0 0 2
1 0 0 0 0 0 0 0 0 0 2
1 0 0 0 0 0 0 0 0 0 2
1 0 0 0 0 0 0 0 0 0 2
1 0 0 0 0 0 0 0 0 0 2
1 0 0 0 0 0 0 0 0 0 2
1 0 0 0 0 0 0 0 0 0 2
1 0 0 0 0 0 0 0 0 0 2
4 3 3 3 3 3 3 3 3 3 5